17
-15
17
-15
000000000000000000000000000000000
111111111111111111111111111111110
111111111111111111111111111111110
111111111111111111111111111111110
111000000000000000000000000001110
111000000000000000000000000001110
111000000000000000000000000001110
111000000000000000000000000001110
111000000000000000000000000001110
111000000000000000000000000001110
111000000000000000000000000001110
111000000000000000000000000001110
111000000000000000000000000001110
111000000000000000000000000001110
111000000000000000000000000001110
111000000000000000000000000001110
111000000000000000000000000001110
111000000000000000000000000001110
111000000000000000000000000001110
111000000000000000000000000001110
111000000000000000000000000001110
111000000000000000000000000001110
111000000000000000000000000001110
111000000000000000000000000001110
111000000000000000000000000001110
111000000000000000000000000001110
111000000000000000000000000001110
111000000000000000000000000001110
111000000000000000000000000001110
101000000000000000000000000001110
111111111111111111111111111111110
111111111111111111111111111111110
111111111111111111111111111111110
