17
-15
17
-15
000000000000000000000000000000000
111111111111111111111111111111110
111111111111111111111111111111110
111111111111111111111111111111110
111111111111111111111111111111110
111111111111111111111111111111110
111111111111111111111111111111110
111111111111111111111111111111110
111111111111111111111111011111110
111111110000000000000001111111110
111111110000000000000001111111110
111111110000000000000001111111110
111111110000000000000001111111110
111111110000000000000001111111110
111111110000000000000001111111110
111111110000000000000001111111110
111111110000000000000001111111110
111111110000000000000001111111110
111111110000000000000001111111110
111111110000000000000001111111110
111111110000000000000001111111110
111111110000000000000001111111110
111111110000000000000001111111110
111111110000000000000001111111110
111111110000000000000001111111110
111111111111111111111111111111110
111111111111111111111111111111110
111111111111111111111111111111110
111111111111111111111111111111110
111111111111111111111111111111110
111111111111111111111111111111110
111111111111111111111111111111110
111111111111111111111111111111110
