17
-15
17
-15
000000000000000000000000000000000
111111111111111111111111111111110
111111111111111111111111111111110
111111111111111111111111111111110
111111111111111111111111111111110
111111111111111111111111111111110
111111111111111111111111111111110
111111111111111111111111111111110
111111111111111111111111111111110
111111111000000000000001111111110
111111111000000000000001111111110
111111110000000000000000111111110
111111110000100010001000111111110
111111110000000000000000111111110
111111110000000000000000111111110
111111110000000000000000111111110
111111110000000010000000111111110
111111110000000000000000111111110
111111110000000000000000111111110
111111110000000000000000111111110
111111110000100010001000111111110
111111110000000000000000111111110
111111110000000000000000111111110
111111111000000000000001111111110
111111111000000000000001111111110
111111111111111111111111111111110
111111111111111111111111111111110
111111111111111111111111111111110
111111111111111111111111111111110
111111111111111111111111111111110
111111111111111111111111111111110
111111111111111111111111111111110
111111111111111111111111111111110
